111111111111111111111111111
1000C11110000C0001001100C01
100C000C00011100C111C110001
100100010001001100000001101
100011100011011001C00000001
100000000000000001000000001
1010000000C1000001000001101
10000111110010000100C000C11
1P0011E0000010C1110000C0111
111111111111111111111111111