111111111111111111111111111
1000C11110000C00010011V0C01
100C000C00011100C111C110001
100100010V01001100000001101
100011100011011001C00000001
10000000000000000100V000001
1010000000C1000001000001101
10V00100110010000100C000C11
1P0011E0000010C1110000C0111
j11111111111111111111111111